NO ./cramptés
SO ./apagnan
EA ./quoicoubeh
WE ./macroncaca
F 100,200,150
C 100,200,150

1111111
1000001
1110011
1001001
1000011
1111111