NO res/wall_0.jpg
SO res/wall_1.jpg
EA res/wall_2.jpg
WE res/wall_3.jpg

F 200,200,200
C 100,100,100


1111111111111111111
1000001000000000001
1010000001100000001111
10010000011000100000001
10000000100000100100011111
10001000000110100000000001
10001000000010100000100001
11111111111111111111111111
