NO ./cramptés
SO ./apagnan
EA ./quoicoubeh
WE ./macroncaca
F 100,200,150
C 100,200,150

1111111111111111111
1000001000000000001
111000000110000000111
1001000001100010000011
10000000100000100100011111
10001000000010100000000001
10001000000010100000100001
11111111111111111111111111
