NO ressources/north.png
SO ressources/south.png
EA ressources/east.png
WE ressources/west.png
F 255,100,100
C 100,200,150


1111111111111111111
1000001000000000001
1010000001100000001111
10010000011000100000001
10000000100000100100011111
10001000000110100000000001
10001000000010100000100001
11111111111111111111111111
