NO ./north
SO ./south
EA ./east
WE ./west
F 255,100,100
C 100,200,150


1111111111111111111
1000001000000000001
101000000110000000111
1001000001100010000001
10000000100000100100011111
10001000000010100000000001
10001000000010100000100001
11111111111111111111111111
